10 10
..........
..#.......
..#...@...
..#.......
..........
$...###...
.........$
.##.......
..@...$...
..........